######################
#....................#
#..............######
#...............#     
#...............######
#.........@.........^#
######...............#
     #...............#
######...............#
#...........e........#
#....................#
######################